1111111
10C0001
1000001
100C0E1
1010001
1000001
1001001
1P01001
1001C01
1111111
1000001
1111111